1111111111111111111
1P00000000000000001
1100000000000000001
10100000000C0000001
1E01000000000000001
1010000000000000001
1100000000000000001
10000000000000000C1
1111111111111111111