1111111111111
1E00C0P000001
1111111111111