1111111111111111111
1000101C00001000011
1000100001ES1000111
1000100100101000011
1100001000001000011
1000000100000101011
1000000SPS000000101
10000000S0000000101
1111111111111111111