111111111111111111
1P0000001010010001
111100000100010011
1E1000000000100101
111100000001000011
110000100001000001
1000000001010000C1
111111111111111111