11111111111
1E010C10111
1000P100011
11111111111