1111111111111111111
100010001CCC10C01E1
10101010101010101C1
1C1C101C10101C1C1C1
101010101C1C1010101
1P100C100010001CC01
1111111111111111111