11111111111
1E000C00P11
11111111111