1111111111111
10010000R00C1
1P00011111001
10001100E0001
1111111111111