1111111111111111111
1000101000101000011
1000100001C11000111
100E1001001P0000011
1100001000001000011
1000000100000101011
100C000000000000101
1000000000000000101
1111111111111111111