1111111111111111111
1000101000101000011
1000100001E00000111
1000100100100000011
1100001000001000011
1000000100000101011
100P000000000000101
1000000000000000101
1111111111111111111