11111111111
100P00E0C01
11111111111