1111111111111111111
1000101000101000011
1000100001E01000111
1000100100101000011
1100001000001000011
1000000100001101011
1000C00000001000101
10000000000001P0101
1111111111111111111