111111111111111111
1CCC1E0000000000C1
1C0100000000000001
1C0100000000000001
1C0100000000000001
1C0100000000000001
1P0100000000000001
111111111111111111