1111111111111111
1C010C100000E011
100001000001C011
10000100CC001011
1000010000C01011
10C00100C0001011
100C010000001011
1P00010C00001011
1111111111111111