111111111111111111
1PC0000000C000SE01
111111111111111111